Abysmal Dawn	death	
Arcturus	black prog	nmt
Benighted	black brutal	Y
Beyond Creation	tech death	Y
Cabrakaan	folk	
Candlemass	doom	
Crownshift	power	Y
Decapitated	tech	
Delaine	symph rock	Y FL
Destinity	black	
Dread Crew of Oddwood	folk	
Emperor	Symph Black	Y
Ex Deo	symph death	YY
Fabulae Dramatis	prog avant	
Finntroll	black folk	nmt
Flotsam Jetsam	power thrash	nmt
Fractal Sun	prog	Y F
HammerFall		
Hate	death	
Ihsahn	prog	Y
In Extremo	folk	
Incantation	death	
Kalmah	death power	
Kissin Dynamite	heavy rock	
Krisiun	death	YY
Lutharo	power	FL
Majestica	symph power	
Matalobos	doom	
Metsatoll	folk	
Mork	black	Y
Onslaught	thrash	nmt
Painful	black death	
Pessimist	deatrh	
Powerglove	power	
Reaping Asmodeia	melo tech	
Samael	black indust	Y
Septicflesh	symph death	YY
Sepultura	death	Y
Seven Kingdoms	power	
Sonata Arctica	power	nmt
Stratovarious	power	nmt
Striker	power	
Subway to Sally	folk	Y
Super Monster Party	power	
Swallow the Sun	melo death	Y
Symphony X	prog power	m
Tankard	thrash	Y
Tenebrarum	black	
The Kovenant	indust goth rock	Y
The Mourning	prog	FL
The Zenith Passage	tech death	YY
Thy Antichrist	black	
Total Death	black doom	
Trollfest	folk	m
Trouble	doom	nmt
Twilight Force	symph power	m
Unleash the Archers	power	Y nmt
Warfield	thrash	
